EmbedUI	KEYWORD1
Font	KEYWORD1
color	KEYWORD2
begin	KEYWORD2
clear	KEYWORD2
addFont	KEYWORD2
setSize	KEYWORD2
createText	KEYWORD2
createTextBox	KEYWORD2
updateText	KEYWORD2
updateTextColor	KEYWORD2
updateTextFont	KEYWORD2
addUnderline	KEYWORD2
setFontWeight	KEYWORD2
setTextNormal	KEYWORD2
setTextBold	KEYWORD2
setTextItalic	KEYWORD2
createLine	KEYWORD2
createRect	KEYWORD2
createRoundRect	KEYWORD2
createCircle	KEYWORD2
createTriangle	KEYWORD2
createButton	KEYWORD2
setGlobalFont	KEYWORD2
updatePosition	KEYWORD2
setVisibility	KEYWORD2
setOpacity	KEYWORD2
setRotation	KEYWORD2
setTransition	KEYWORD2
removeObject	KEYWORD2
addEvent	KEYWORD2
handleEvents	KEYWORD2
updateButtonText	KEYWORD2
createImageFromLink	KEYWORD2
createImageFromFile	KEYWORD2
createVideoFromLink	KEYWORD2
createVideoFromFile	KEYWORD2
createFilledRect	KEYWORD2
createFilledRoundRect	KEYWORD2
setTextAlignment	KEYWORD2
createFilledCircle	KEYWORD2
createFilledTriangle	KEYWORD2
addStrikeThrough	KEYWORD2
setForegroundColor	KEYWORD2
setBackgroundColor	KEYWORD2
openExternalLink	KEYWORD2
setDisplayBackgroundColor	KEYWORD2
LINEAR	LITERAL1
SOFT	LITERAL1
CLICK_EVENT	LITERAL1
HOVER_EVENT	LITERAL1
MOUSE_IN_EVENT	LITERAL1
MOUSE_OUT_EVENT	LITERAL1
SOFT_START	LITERAL1
SOFT_END	LITERAL1
SOFT_START_END	LITERAL1
CENTER_ALIGN	LITERAL1
LEFT_ALIGN	LITERAL1
RIGHT_ALIGN	LITERAL1
JUSTIFY_TEXT	LITERAL1